1111111111111111111111111111n
1111311111111111111111131111n
1113231111111111111111323111n
1132223111111111111113222311n
1113231111111111111111323111n
1111311111111121111111131111n
1115111111111232111111115111n
1111511111111121111111151111n
1111155111111111111115511111n
1111115551111111111555111111n
1111111155551111555541111111n
1111111111155555544444111111n
1111111111111111114444111111n
1111111111111111111441111111n
1111111111111111111111111111n
